20 30
##############################
#                            #
#                            #
#                            #
#                            #
#            *               #
#                            #
#                            #
#                            #
# >          *               #
#                            #
#                            #
#                            #
#                            #
#                            #
#                            #
#                            #
#                            #
#                            #
##############################